111111111111111111111111111111
10001000000P000000000000000001
100010100000000000001000000001
101110100000000111111111111101
101000100000000100000000000001
1C10001000C0000100000000000001
101111100000000100000000000001
100000100001111111110000000001
111100100000000000000000000001
1000000000011000C0000000000001
1001111110011111111100000E0001
100C00100001000000000000000001
111111100001111111111111111001
100000000000000000000000000001
111111111111111111111111111111