111111111111111111111111111111
100010000000000000000000000001
10P010100000000000001000000001
101110100000000111111111111101
101000100000000100000000000001
1C10001000C0000100000000000001
101111100000000100000000000001
100000100001111111110000000001
111100100000000000000000000001
1000000000011000C0000000000001
100111111001111111110000000001
100C001000010000000000000E0001
111111100001111111111111111001
100000000000000000000000000001
111111111111111111111111111111