111111111111111
100000000000001
100111111100001
100000000100001
10P000000100E01
111111111111111