1111111111
1P000C0001
10000C0001
1C00C00E01
1111111111