11111111111111111111
1P110C00000000000001
10110011100000000001
10100010E00001110001
10111111100001C11111
1C011000000000000001
10001100000000000001
10011000C00000000001
1000C000000000000001
11111111111111111111