11111111
1P10C001
10101001
100010E1
11111111