11111111
1P100011
10101011
100C10E1
11111111