11111111
1P100001
101011E1
100011C1
11111111