11111111
1P100001
10101001
100C10E1
11111111